0 0 0 0 N E S W
0 1 0 0 N E S W
0 1 0 0 N E S W
0 1 0 0 N E S W
0 1 0 0 N E S W
0 1 0 0 N E S W
0 0 1 0 N E S W
1 0 0 0 N E S W
0 1 0 0 N E S W
0 1 0 0 N E S W
0 0 0 0 N E S W
0 0 0 0 N E S W
0 1 0 0 N E S W
0 1 0 0 N E S W
0 1 0 0 N E S W
0 1 0 0 N E S W
0 0 0 0 N E S W
0 0 0 0 N E S W
0 0 0 0 N E S W
0 0 0 0 N E S W
0 0 0 0 N E S W
0 0 0 0 N E S W
0 0 0 0 N E S W
0 0 0 0 N E S W
0 0 0 0 N E S W
0 0 0 0 N E S W
0 0 0 0 N E S W
0 0 0 0 N E S W
0 0 0 0 N E S W
0 0 0 0 N E S W
0 0 0 0 N E S W
0 0 0 0 N E S W
0 0 0 0 N E S W
0 0 0 0 N E S W
0 0 0 0 N E S W
0 0 0 0 N E S W
0 0 0 0 N E S W
0 0 0 0 N E S W
0 0 0 0 N E S W
0 0 0 0 N E S W
0 0 0 0 N E S W
0 0 0 0 N E S W
0 0 0 0 N E S W
0 0 0 0 N E S W
0 0 0 0 N E S W
0 0 0 0 N E S W
0 0 0 0 N E S W
0 0 0 0 N E S W
0 0 0 0 N E S W
0 0 0 0 N E S W
0 0 0 0 N E S W
0 0 0 0 N E S W
0 0 0 0 N E S W
0 0 0 0 N E S W
0 0 0 0 N E S W
0 0 0 0 N E S W
0 0 0 0 N E S W
0 0 0 0 N E S W
0 0 0 0 N E S W
0 0 0 0 N E S W
0 0 0 0 N E S W
0 0 0 0 N E S W
0 0 0 0 N E S W
0 0 0 0 N E S W
0 0 0 0 N E S W
0 0 0 0 N E S W
0 0 0 0 N E S W
0 0 0 0 N E S W
0 0 0 0 N E S W
0 0 0 0 N E S W
0 0 0 0 N E S W
0 0 0 0 N E S W
0 0 0 0 N E S W
0 0 0 0 N E S W
0 0 0 0 N E S W
0 0 0 0 N E S W
0 0 0 0 N E S W
0 0 0 0 N E S W
0 0 0 0 N E S W
0 0 0 0 N E S W
0 0 0 0 N E S W
0 0 0 0 N E S W
0 0 0 0 N E S W
0 0 0 0 N E S W
0 0 0 0 N E S W
0 0 0 0 N E S W
0 0 0 0 N E S W
0 0 0 0 N E S W
0 0 0 0 N E S W
0 0 0 0 N E S W
0 0 0 0 N E S W
0 0 0 0 N E S W
0 0 0 0 N E S W
0 0 0 0 N E S W
0 0 0 0 N E S W
0 0 0 0 N E S W
0 0 0 0 N E S W
0 0 0 0 N E S W
0 0 0 0 N E S W
0 0 0 0 N E S W
0 0 0 0 N E S W
0 0 0 0 N E S W
0 0 0 0 N E S W
0 0 0 0 N E S W
0 0 0 0 N E S W
0 0 0 0 N E S W
0 0 0 0 N E S W
0 0 0 0 N E S W
0 0 0 0 N E S W
0 0 0 0 N E S W
0 0 0 0 N E S W
0 0 0 0 N E S W
0 0 0 0 N E S W
0 0 0 0 N E S W
0 0 0 0 N E S W
0 0 0 0 N E S W
0 0 0 0 N E S W
0 0 0 0 N E S W
0 0 0 0 N E S W
0 0 0 0 N E S W
0 0 0 0 N E S W
0 0 0 0 N E S W
0 0 0 0 N E S W
0 0 0 0 N E S W
0 0 0 0 N E S W
0 0 0 0 N E S W
0 0 0 0 N E S W
0 0 0 0 N E S W
0 0 0 0 N E S W
0 0 0 0 N E S W
0 0 0 0 N E S W
0 0 0 0 N E S W
0 0 0 0 N E S W
0 0 0 0 N E S W
0 0 0 0 N E S W
0 0 0 0 N E S W
0 0 0 0 N E S W
0 0 0 0 N E S W
0 0 0 0 N E S W
0 0 0 0 N E S W
0 0 0 0 N E S W
0 0 0 0 N E S W
0 0 0 0 N E S W
0 0 0 0 N E S W
0 0 0 0 N E S W
0 0 0 0 N E S W
0 0 0 0 N E S W
0 0 0 0 N E S W
0 0 0 0 N E S W
0 0 0 0 N E S W
0 0 0 0 N E S W
0 0 0 0 N E S W
0 0 0 0 N E S W
0 0 0 0 N E S W
0 0 0 0 N E S W
0 0 0 0 N E S W
0 0 0 0 N E S W
0 0 0 0 N E S W
0 0 0 0 N E S W
0 0 0 0 N E S W
0 0 0 0 N E S W
0 0 0 0 N E S W
0 0 0 0 N E S W
0 0 0 0 N E S W
0 0 0 0 N E S W
0 0 0 0 N E S W
0 0 0 0 N E S W
0 0 0 0 N E S W
0 0 0 0 N E S W
0 0 0 0 N E S W
0 0 0 0 N E S W
0 0 0 0 N E S W
0 0 0 0 N E S W
0 0 0 0 N E S W
0 0 0 0 N E S W
0 0 0 0 N E S W
0 0 0 0 N E S W
0 0 0 0 N E S W
0 0 0 0 N E S W
0 0 0 0 N E S W
0 0 0 0 N E S W
0 0 0 0 N E S W
0 0 0 0 N E S W
0 0 0 0 N E S W
0 0 0 0 N E S W
0 0 0 0 N E S W
0 0 0 0 N E S W
0 0 0 0 N E S W
0 0 0 0 N E S W
0 0 0 0 N E S W
0 0 0 0 N E S W
0 0 0 0 N E S W
0 0 0 0 N E S W
0 0 0 0 N E S W
0 0 0 0 N E S W
0 0 0 0 N E S W
0 0 0 0 N E S W
0 0 0 0 N E S W
0 0 0 0 N E S W
0 0 0 0 N E S W
0 0 0 0 N E S W
0 0 0 0 N E S W
0 0 0 0 N E S W
0 0 0 0 N E S W
0 0 0 0 N E S W
0 0 0 0 N E S W
0 0 0 0 N E S W
0 0 0 0 N E S W
0 0 0 0 N E S W
0 0 0 0 N E S W
0 0 0 0 N E S W
0 0 0 0 N E S W
0 0 0 0 N E S W
0 0 0 0 N E S W
0 0 0 0 N E S W
0 0 0 0 N E S W
0 0 0 0 N E S W
0 0 0 0 N E S W
0 0 0 0 N E S W
0 0 0 0 N E S W
0 0 0 0 N E S W
0 0 0 0 N E S W
0 0 0 0 N E S W
0 0 0 0 N E S W
0 0 0 0 N E S W
0 0 0 0 N E S W
0 0 0 0 N E S W
0 0 0 0 N E S W
0 0 0 0 N E S W
0 0 0 0 N E S W
0 0 0 0 N E S W
0 0 0 0 N E S W
0 0 0 0 N E S W
0 0 0 0 N E S W
0 0 0 0 N E S W
0 0 0 0 N E S W
0 0 0 0 N E S W
0 0 0 0 N E S W
0 0 0 0 N E S W
0 0 0 0 N E S W
0 0 0 0 N E S W
0 0 0 0 N E S W
0 0 0 0 N E S W
0 0 0 0 N E S W
0 0 0 0 N E S W
0 0 0 0 N E S W
0 0 0 0 N E S W
0 0 0 0 N E S W
0 0 0 0 N E S W
0 0 0 0 N E S W
0 0 0 0 N E S W
0 0 0 0 N E S W
0 0 0 0 N E S W
1 1 1 1 N E S W
0 0 0 0 N E S W
0 0 0 0 N E S W
